#############################################
#  #      #         #   #       #         # #
# ## #### # ##### ### # ### ###   ### ### # #
#       #   #   #   #   #   #   #   #       #
# ### # ### # # ### ### # # ### ########### #
#   # # #   # #   #   # # #       #   #     #
# # # # # ### ##### ### # # ##### # # # #####
# #   # #   #     #           #   # #     # #
# ### # ##### # ### # ### # ### ##### # # # #
#   # #       # #   # #   # # #       #   # #
# # ### ####### # # # # # # # ############# #
# #     #       ###   #   #     ###     #   #
# ##### # # # # # #############   # # # # # #
#   #   # # #   #     #   # #   #   # # #   #
# # ########### #### ## # # ### ##### ### ###
# #   #       #         #   # #   #   # #   #
# ### # # ##### ### ##### # # # # # #   ### #
#     # #     #   #   #   # #   # # # #     #
# ### ### ### ##### # # # ####### # # #######
#   #   #   #     # # # #       # # #     # #
## ## # ##### # # # # ##### ### ### ## # ## #
#     #   #   # # # #   #   #       #  #    #
# ### ##### # # # ##### # ##### ### #########
# #     #   # # #       # #     #           #
# # ##### # # # ######### # ##### # ##### ###
# #       #   #       #   #       #     #   #
#############################################
